#######
#     #
#     #
####  #
#     #
#  ####
#     #
###  ##
#######